################################
#....~~~~~.....~~~~~~..........#
#....~~~~~.....~~~~~~..........#
#....######....######~~~~~~~~..#
#....#....#....#.....~~~~~~~~..#
#.........#..........~~~~~~~~..#
#####################..........#
#........##....................#
#........##........##..........#
#~~~~~~~~##~~~~~~~~##~~~~~~~~..#
#~~~~~~~~##~~~~~~~~##~~~~~~~~..#
#~~~~~~~~##~~~~~~~~##~~~~~~~~..#
#~~~~~~~~##~~~~~~~~##~~~~~~~~..#
#~~~~~~~~##~......~##~~~~~~~~..#
#~~~~~~~~##~......~##~~~~~~~~..#
#~~~~~~~~##~......~##~~~~~~~~..#
#~~~~~~~~##~......~##~~~~~~~~..#
#~~~~~~~~##~~~~~~~~##~~~~~~~~..#
#~~~~~~~~##~~~~~~~~##~~~~~~~~..#
#~~~~~~~~##~~~~~~~~##~~~~~~~~..#
#..................##..........#
#..................##..........#
################################